0 1 1 1 2 1 3 1 4 1 5 1 6 1 7 1 8 1 9 1 10 1 11 1 12 1 13 1 14 1 15 1 16 1 17 1 18 1 19 1 20 1 21 1 22 1 23 1 24 1 25 1 26 1 27 1 
28 1 29 3 30 4 31 4 32 4 33 4 34 3 35 4 36 4 37 4 38 4 39 4 40 3 41 1 42 1 43 3 44 4 45 4 46 4 47 4 48 4 49 3 50 4 51 4 52 4 53 4 54 3 55 1 
56 1 57 4 58 1 59 1 60 1 61 1 62 4 63 1 64 1 65 1 66 1 67 1 68 4 69 1 70 1 71 4 72 1 73 1 74 1 75 1 76 1 77 4 78 1 79 1 80 1 81 1 82 4 83 1 
84 1 85 4 86 1 87 1 88 1 89 1 90 4 91 1 92 1 93 1 94 1 95 1 96 4 97 1 98 1 99 4 100 1 101 1 102 1 103 1 104 1 105 4 106 1 107 1 108 1 109 1 110 4 111 1 
112 1 113 5 114 1 115 1 116 1 117 1 118 4 119 1 120 1 121 1 122 1 123 1 124 4 125 1 126 1 127 4 128 1 129 1 130 1 131 1 132 1 133 4 134 1 135 1 136 1 137 1 138 5 139 1 
140 1 141 3 142 4 143 4 144 4 145 4 146 3 147 4 148 4 149 3 150 4 151 4 152 3 153 4 154 4 155 3 156 4 157 4 158 3 159 4 160 4 161 3 162 4 163 4 164 4 165 4 166 3 167 1 
168 1 169 4 170 1 171 1 172 1 173 1 174 4 175 1 176 1 177 4 178 1 179 1 180 1 181 1 182 1 183 1 184 1 185 1 186 4 187 1 188 1 189 4 190 1 191 1 192 1 193 1 194 4 195 1 
196 1 197 4 198 1 199 1 200 1 201 1 202 4 203 1 204 1 205 4 206 1 207 1 208 1 209 1 210 1 211 1 212 1 213 1 214 4 215 1 216 1 217 4 218 1 219 1 220 1 221 1 222 4 223 1 
224 1 225 3 226 4 227 4 228 4 229 4 230 3 231 1 232 1 233 3 234 4 235 4 236 3 237 1 238 1 239 3 240 4 241 4 242 3 243 1 244 1 245 3 246 4 247 4 248 4 249 4 250 3 251 1 
252 1 253 1 254 1 255 1 256 1 257 1 258 4 259 1 260 1 261 1 262 1 263 1 264 0 265 1 266 1 267 0 268 1 269 1 270 1 271 1 272 1 273 4 274 1 275 1 276 1 277 1 278 1 279 1 
280 1 281 1 282 1 283 1 284 1 285 1 286 4 287 1 288 1 289 1 290 1 291 1 292 0 293 1 294 1 295 0 296 1 297 1 298 1 299 1 300 1 301 4 302 1 303 1 304 1 305 1 306 1 307 1 
308 1 309 1 310 1 311 1 312 1 313 1 314 4 315 1 316 1 317 2 318 0 319 0 320 2 321 0 322 0 323 2 324 0 325 0 326 2 327 1 328 1 329 4 330 1 331 1 332 1 333 1 334 1 335 1 
336 1 337 1 338 1 339 1 340 1 341 1 342 4 343 1 344 1 345 0 346 1 347 1 348 1 349 0 350 0 351 1 352 1 353 1 354 0 355 1 356 1 357 4 358 1 359 1 360 1 361 1 362 1 363 1 
364 1 365 1 366 1 367 1 368 1 369 1 370 4 371 1 372 1 373 0 374 1 375 0 376 0 377 0 378 0 379 0 380 0 381 1 382 0 383 1 384 1 385 4 386 1 387 1 388 1 389 1 390 1 391 1 
392 0 393 0 394 0 395 0 396 0 397 0 398 3 399 0 400 0 401 2 402 1 403 0 404 0 405 0 406 0 407 0 408 0 409 1 410 2 411 0 412 0 413 3 414 0 415 0 416 0 417 0 418 0 419 0 
420 1 421 1 422 1 423 1 424 1 425 1 426 4 427 1 428 1 429 0 430 1 431 0 432 0 433 0 434 0 435 0 436 0 437 1 438 0 439 1 440 1 441 4 442 1 443 1 444 1 445 1 446 1 447 1 
448 1 449 1 450 1 451 1 452 1 453 1 454 4 455 1 456 1 457 0 458 1 459 1 460 1 461 1 462 1 463 1 464 1 465 1 466 0 467 1 468 1 469 4 470 1 471 1 472 1 473 1 474 1 475 1 
476 1 477 1 478 1 479 1 480 1 481 1 482 4 483 1 484 1 485 2 486 0 487 0 488 0 489 0 490 0 491 0 492 0 493 0 494 2 495 1 496 1 497 4 498 1 499 1 500 1 501 1 502 1 503 1 
504 1 505 1 506 1 507 1 508 1 509 1 510 4 511 1 512 1 513 0 514 1 515 1 516 1 517 1 518 1 519 1 520 1 521 1 522 0 523 1 524 1 525 4 526 1 527 1 528 1 529 1 530 1 531 1 
532 1 533 1 534 1 535 1 536 1 537 1 538 4 539 1 540 1 541 0 542 1 543 1 544 1 545 1 546 1 547 1 548 1 549 1 550 0 551 1 552 1 553 4 554 1 555 1 556 1 557 1 558 1 559 1 
560 1 561 3 562 4 563 4 564 4 565 4 566 3 567 4 568 4 569 3 570 4 571 4 572 3 573 1 574 1 575 3 576 4 577 4 578 3 579 4 580 4 581 3 582 4 583 4 584 4 585 4 586 3 587 1 
588 1 589 4 590 1 591 1 592 1 593 1 594 4 595 1 596 1 597 1 598 1 599 1 600 4 601 1 602 1 603 4 604 1 605 1 606 1 607 1 608 1 609 4 610 1 611 1 612 1 613 1 614 4 615 1 
616 1 617 4 618 1 619 1 620 1 621 1 622 4 623 1 624 1 625 1 626 1 627 1 628 4 629 1 630 1 631 4 632 1 633 1 634 1 635 1 636 1 637 4 638 1 639 1 640 1 641 1 642 4 643 1 
644 1 645 6 646 4 647 3 648 1 649 1 650 3 651 4 652 4 653 3 654 4 655 4 656 3 657 0 658 0 659 3 660 4 661 4 662 3 663 4 664 4 665 3 666 1 667 1 668 3 669 4 670 6 671 1 
672 1 673 1 674 1 675 4 676 1 677 1 678 4 679 1 680 1 681 4 682 1 683 1 684 1 685 1 686 1 687 1 688 1 689 1 690 4 691 1 692 1 693 4 694 1 695 1 696 4 697 1 698 1 699 1 
700 1 701 1 702 1 703 4 704 1 705 1 706 4 707 1 708 1 709 4 710 1 711 1 712 1 713 1 714 1 715 1 716 1 717 1 718 4 719 1 720 1 721 4 722 1 723 1 724 4 725 1 726 1 727 1 
728 1 729 3 730 4 731 3 732 4 733 4 734 3 735 1 736 1 737 3 738 4 739 4 740 3 741 1 742 1 743 3 744 4 745 4 746 3 747 1 748 1 749 3 750 4 751 4 752 3 753 4 754 3 755 1 
756 1 757 4 758 1 759 1 760 1 761 1 762 1 763 1 764 1 765 1 766 1 767 1 768 4 769 1 770 1 771 4 772 1 773 1 774 1 775 1 776 1 777 1 778 1 779 1 780 1 781 1 782 4 783 1 
784 1 785 4 786 1 787 1 788 1 789 1 790 1 791 1 792 1 793 1 794 1 795 1 796 4 797 1 798 1 799 4 800 1 801 1 802 1 803 1 804 1 805 1 806 1 807 1 808 1 809 1 810 4 811 1 
812 1 813 3 814 4 815 4 816 4 817 4 818 4 819 4 820 4 821 4 822 4 823 4 824 3 825 4 826 4 827 3 828 4 829 4 830 4 831 4 832 4 833 4 834 4 835 4 836 4 837 4 838 3 839 1 
840 1 841 1 842 1 843 1 844 1 845 1 846 1 847 1 848 1 849 1 850 1 851 1 852 1 853 1 854 1 855 1 856 1 857 1 858 1 859 1 860 1 861 1 862 1 863 1 864 1 865 1 866 1 867 1 
